NO ./wolftex/purplestone.xpm
EA ./wolftex/eagle.xpm
WE ./wolftex/fuhrer.xpm






SO       ./wolftex/redbrick.xpm
R 1280 720
S1 ./wolftex/barrel.xpm
S2 ./wolftex/pillar.xpm
F 28,189    ,    42 
C         134,231,236

1111111111111111111111111
1003000200110000001110001
1000000000110003000000001
10200000000200000010000W1
1002000000000000200003001
1000211000020000000020001
1110101002000001111000001
1200000110300200001000011
1111111111111111111111111





