NO ./wolftex/purplestone.xpm
EA ./wolftex/eagle.xpm
WE ./wolftex/fuhrer.xpm






SO       ./wolftex/redbrick.xpm
R 610 441
S1 ./wolftex/barrel.xpm
S2 ./wolftex/pillar.xpm
F 28,189    ,    42 
C         134,231,236

1111111111111111111111111
1003000200110000001110001
1000020002110003000000001
10200202002200200010000W1
1002000000000220200003001
1000211200020202000020001
1110101002002001111000001
1200000110300200001020011
1111111111111111111111111





