1111   111
1001   101
1001   111
1111
