         1111   111
         1001   10
         1001   111
         1111
