         111
         101   11
         1111
