NO ./wolftex/purplestone.xpm
EA ./wolftex/eagle.xpm
WE ./wolftex/fuhrer.xpm
SO ./wolftex/redbrick.xpm
R 640  400
S ./wolftex/barrel.xpm
F 28,189,42
C 134,231,236

1111111111111111111111111
1000000000110000000000001
1000000000110000000000001
1000000200022002000000001
1000000002000220200000001
1000000201020202000020001
1000100000000000100000001
10001000000000000000N0001
1000000000000000000000001
1000000000000200000020001
1000000000000000000000001
1000000000020000000000001
1000000000000000000000001
1000000000000000000000001
1000000000000000000000001
1111111111111111111111111
