NO ./wolftex/greystone.png
SO ./wolftex/redbrick.png
EA ./wolftex/wood.png
WE ./wolftex/wood.png
R 1000 500
S ./wolftex/barrel.png
F 28,189,42
C 134,231,236

        1111111111111111111111111
        1000000000110000000000001
        1011000001110000000000011
        1001000000000000000000001
1111111110110000011100N0001000001
100000000011000001110111111111111
11110111111111011100000010001
11110111111111011101010010001
11000000110101011100000010001
10002000000000001100000010001
10000000000000001101010010001
1100000111010101111101111000111
11110111 1110101 101111010001
11111111 1111111 111111111111
