NO ./wolftex/purplestone.xpm
EA ./wolftex/eagle.xpm
WE ./wolftex/fuhrer.xpm
SO ./wolftex/redbrick.xpm
R 701   411
S ./wolftex/barrel.xpm
F 28,189,42
C 134,231,236

        1111111111111111111111111
        1000000000110000000000001
        1011000001110000000200001
        1001000000000000020000001
111111111011000001110020000000W01
100000000011000001110111111111111
11110111111111011100000010001
11110111111111011101010010001
11000000110101011100000010001
10002000000000001100000010001
10000000000000001101010010001
110000011101010111110111100111
11110111 1110101 101111010001
11111111 1111111 111111111111
