NO ./wolftex/purplestone.xpm
EA ./wolftex/eagle.xpm
WE ./wolftex/fuhrer.xpm
SO ./wolftex/redbrick.xpm
R 801    511
S ./wolftex/pillar.xpm
F 28,189,42
C 134,231,236

11111111111111
10000000000001
10020000000001
10000000000001
10000002000001
10000000000001
10000000000001
10000000000001
100000N0000001
11111111111111

