R 1080 720
NO ./wolftex/greystone.png
SO ./wolftex/redbrick.png
EA ./wolftex/wood.png
WE ./wolftex/wood.png
S ./wolftex/barrel.png
C 255,200,160
F 122,122,122

1111
1N01
1111
