NO ./wolftex/greystone.png
SO ./wolftex/redbrick.png
EA ./wolftex/wood.png
WE ./wolftex/wood.png
R 1000 500
S ./wolftex/barrel.png
F 28,189,42
C 134,231,236

11111111111111111
10000000000000001
10000000000000001
10000000000N00001
10000000000000001
10000000000000001
11111111111111111
