NO ./wolftex/purplestone.xpm
EA ./wolftex/eagle.xpm
WE ./wolftex/fuhrer.xpm
SO ./wolftex/redbrick.xpm
R 801    511
S ./wolftex/barrel.xpm
F 28,189,42
C 134,231,236

11111111111111
11012000000021
11200100000001
12000020000001
10000001000001
10000000000001
10000000000001
10N00000000001
12000000000021
11111111111111

