R 700   	  			     420   			  
NO ./wolftex/greystone.png





SO ./wolftex/redbrick.png
EA ./wolftex/wood.png
WE ./wolftex/wood.png
S ./wolftex/barrel.png
C 25     				,  		   		 200			  		 	 	 ,				    160
F 111 , 122, 122

11111111111111111111 
  110000000000000111
  100000000000000011
 1100000000002001111
 1000000000000000001
 100000000N000000211
 11000000000000000011111111111
  110011000000000001
   10110000000000111
   11111111111111111  
