NO ./wolftex/purplestone.xpm
EA ./wolftex/eagle.xpm
WE ./wolftex/fuhrer.xpm
SO ./wolftex/redbrick.xpm
R 801    511
S ./wolftex/pillar.xpm
F 28,189,42
C 134,231,236

11111111111111
10110020012001
10000001000001
10000010010001
10000000N00001
10000000000001
10000000000001
10000000000001
10000000000001
11111111111111

