NO ./wolftex/bluestone.xpm
EA ./wolftex/eagle.xpm
WE ./wolftex/fuhrer.xpm
SO ./wolftex/redbrick.xpm
R 800    600
S ./wolftex/barrel.png
F 28,189,42
C 134,231,236



        1111111111111111111111111
        10000000001100N0000000001
        1011000001110000000000011
        1001000000000000000000001
111111111011000001110000001000001
100000000011000001110111111111111
11110111111111011100000010001
11110111111111011101010010001
11000000110101011100000010001
10002000000000001100000010001
10000000000000001101010010001
1100000111010101111101111000111
11110111 1110101 101111010001
11111111 1111111 111111111111
