NO ./wolftex/bluestone.xpm
EA ./wolftex/eagle.xpm
WE ./wolftex/fuhrer.xpm
SO ./wolftex/redbrick.xpm
R 401    301
S ./wolftex/pillar.xpm
F 28,189,42
C 134,231,236



        1111111111111111111111111
        1000020000110000000020001
        10110000011100E0000200011
        1201020000020002000000001
111111111011000001110200001000001
100000000011200001110111111111111
11110111111111011100200010001
11110111111111011101010010001
11000000110101011100000010001
10002000000020001120020010001
10000020000000001101010010001
1120000111010101111101111000111
11110111 1110101 101111010001
11111111 1111111 111111111111
