R 1080 720
NO ./wolftex/greystone.png
   SO ./wolftex/redbrick.png
						EA ./wolftex/wood.png
WE ./wolftex/wood.png
S ./wolftex/barrel.png
C 255,122,0
F 0,122,255


        1111111111111111111111111
        1000000001110000000000001
        1011000001110000002000001
        1001002000000000000000001
111111111011000001110000000000001
100000000011000001110111111111111
11110111111111011100000010001
11110111111111011101010010001
11100000110101011100000010001
 2002000000000001100000010001
11100000000000001101010010001
11000001110101011111011110N0111
11110111 1110101 101111010001
11111111 1111111 111111111111
