R 700   	  			     420   			  
NO ./wolftex/greystone.png





SO ./wolftex/redbrick.png
EA ./wolftex/wood.png
WE ./wolftex/wood.png
S ./wolftex/barrel.png
C 25     				,  		   		 200			  		 	 	 ,				    160
F 111 , 122, 122
1111111 
  11111
  100011
 1102001111
 1000000001
 10000E0211
 11000011111111111
  110011         1
   1011          111
   111         1111111  
