NO ./wolftex/purplestone.xpm
EA ./wolftex/eagle.xpm
WE ./wolftex/fuhrer.xpm
SO ./wolftex/redbrick.xpm
R 640  400
S ./wolftex/barrel.xpm
F 28,189,42
C 134,231,236

1111111111111111111111111
1000000000110000000000001
1000000000110000000000001
1000000200022002000200001
1000000002000220200020001
1000000200020202000020001
1000000000000000000000001
100000000000N000000000001
1000000000000000000000001
1000000000000000000000001
1000000000000000000000001
1000000000000000000000001
1000000000000000000000001
1000000000000000000000001
1000000000000000000000001
1111111111111111111111111
