NO ./wolftex/greystone.png
SO ./wolftex/redbrick.png
EA ./wolftex/wood.png
WE ./wolftex/wood.png
R 600 400
S ./wolftex/barrel.png
C 255,200,160
F 122,122,122

11111111111
10000000001
10100100101
10000N00001
10001000101
10000000001
10000000001
10001000001
10000000001
11111111111
