NO ./wolftex/purplestone.xpm
EA ./wolftex/eagle.xpm
WE ./wolftex/fuhrer.xpm






SO       ./wolftex/redbrick.xpm
R 641 401
S ./wolftex/pillar.xpm
F 28,189    ,    42 
C         134,231,236

1111111111111111111111111
1000000200110000001110001
1000020002110000000100001
10200202E0022002000000001
1002000000000220200000001
1000211200020202000020001
1110101002002001111000001
1200000110000200001020011
1111111111111111111111111





