NO ./wolftex/greystone.png
SO ./wolftex/redbrick.png
EA ./wolftex/wood.png
WE ./wolftex/wood.png
R 1000 500
S ./wolftex/barrel.png
C 255,200,160
F 122,122,122



11111111111111111111
10000000000000000001
10000100010000100001
10000000000000000001
10000000000000000001
10000000000000000001
10000000N00000000001
10000000000000000001
10000000000000000011
11111111111111111111
