

SO ./wolftex/redbrick.png                  
                                                                NO ./wolftex/greystone.png                     





                                    R 1080 720







                                                                    F 122,122,122
EA ./wolftex/wood.png                   
            WE ./wolftex/wood.png                 		
                                                S ./wolftex/barrel.png
                                C 255,200,160

11111111111111111
10202020002020201     
11000000000000001
 1110000000000001111  1111
11110002000200200001  10S11
10000000000000011111  11111
10200000200002001   
10000000000000001
11111111111111111
