NO ./wolftex/purplestone.xpm
EA ./wolftex/eagle.xpm
WE ./wolftex/fuhrer.xpm






SO       ./wolftex/redbrick.xpm
R 641 401
S ./wolftex/barrel.xpm
F 28,189    ,    42 
C         134,231,236

1111111111111111111111111
1000000200110000000000001
1000020002110000000000001
1020020200022002000000001
1002000000000220200000001
1000200200020202000020001
1000000000000000000000001
1000000000000000000000001
1000000000000000000000001
1000000000000000000000001
1000000000000000000000001
1000000000000000000000001
1002100002002000100000001
1000000000000000000000001
1000N00000000000000000001
1000000000000000000000001
1000000000000200000020001
1000000000000000000000001
1000000000000000000000001
1000000000000000000000001
1000000000000000000000001
1000000000000000000000001
1111111111111111111111111





