NO ./wolftex/greystone.png
SO ./wolftex/redbrick.png
EA ./wolftex/wood.png
WE ./wolftex/wood.png
R 1000 500
S ./wolftex/barrel.png
F 28,189,42
C 134,231,236

11111
1N1
11111
10001
11111
