NO ./wolftex/purplestone.xpm
EA ./wolftex/eagle.xpm
WE ./wolftex/fuhrer.xpm
SO       ./wolftex/redbrick.xpm
R 1280 720
S ./wolftex/pillar.xpm
F 28,189    ,    42 
C         134,231,236

1111111111111111111111111
1000000200110000001110001
1000000000110000000000001
1000000200020000000100001
1002000000000002000010001
100001100000W000000020001
1110102000002001111000001
1200000110000200001020011
1111111111111111111111111





