NO ./wolftex/purplestone.xpm
EA ./wolftex/eagle.xpm
WE ./wolftex/fuhrer.xpm
SO       ./wolftex/redbrick.xpm
R 610 441
S ./wolftex/pillar.xpm
F 28,189    ,    42 
C         134,231,236

1111111111111111111111111
1000000200110000001110001
1000000000110000000000001
10000002000200000010000W1
1002000000000002000000001
1000011200000000000020001
1110101000002001111000001
1200000110000200001020011
1111111111111111111111111





