NO ./wolftex/greystone.png
SO ./wolftex/redbrick.png
EA ./wolftex/wood.png
WE ./wolftex/wood.png
R 1080 720
S ./wolftex/barrel.png
C 255,200,160
F 122,122,122

11111111111111111
10000000000000001
10100100100000101
10000000000000001
10001000100010001
10000000000000001
10101110N01010101
10000000000000001
10001000100100001
10000000000000001
10100000100001001
10000000000000001
11111111111111111
