NO ./wolftex/purplestone.xpm
EA ./wolftex/eagle.xpm
WE ./wolftex/fuhrer.xpm
SO ./wolftex/redbrick.xpm
R 401   211
S ./wolftex/barrel.xpm
F 28,189,42
C 134,231,236

11111111111111
11012000000021
11200100000001
12000020000001
10000001000001
10000000000001
10000000000001
1000N000000021
10000000000001
11111111111111

