R 1080 720
NO ./wolftex/greystone.png
EA ./wolftex/wood.png
S ./wolftex/redbrick.png
WE ./wolftex/wood.png
SO ./wolftex/barrel.png
C ,200,160
F 122 , 122  ,  122

11111111111111111
10000000000000001
10200000200000201
10000000000000001
10002000200020001
11100000000000001
10202020N02020201
10000000000000001
10002000200200001
10000000000000001
10200000200002001
10000000000000011
1111111111111111
