R 1080   	  			     720   			  
NO ./wolftex/greystone.png





SO ./wolftex/redbrick.png
EA ./wolftex/wood.png
WE ./wolftex/wood.png
S ./wolftex/barrel.png
C 25     				,  		   		 200			  		 	 	 ,				    160
F 111,122,122
11111111
  1N11
  1011
  111
